1111111111111111
1C00000000000001
1C0000P000000001
1000C00000000001
10E0000C00000001
1111111111111111