1111111111111111111111111111111111111111
1C00000000000000000000000000000000000001
1C00000000000000000000000000000000000001
1C00000000000000000000000000000000000001
1C00000000000000000000000000000000000001
1C00000000000000000000000000000000000001
1C00000000000000000000000000000000000001
1C00000000000000000000000000000000000001
1C00000000000000000000000000000000000001
1C00000000000000000000000000000000000001
1C00000000000000000000000000000000000001
1C00000000000000000000000000000000000001
1000000000000000000000000000000P00000001
1000000000000000000000000000000000000001
10E0000000000000000000000000000000000001
1111111111111111111111111111111111111111
1111111111111111111111111111111111111111
1110000000000000000000000000000000000011
1111111111111111111111111111111111111111