1111111111
10000000E1
10000C0001
1000000001
10P0000001
1111111111